О Очки І Сыгранные матчи	ы
Не було ніяких політичних поступок сказав він в інтерв'ю Профіль Україна повідомляють Новости Украина	аи
У нас нормальные отношения	ы
_За матеріалами __Новый мост_	ы
Памятка иностранному гражданину высококвалифицированному специалисту	ы
На даний час выдбувається експорт 0,5 тис МВт у нас відбуваються перетоки з Україною	ы
Любопытство моё было подогрето тем что МВД Украины где даже первые лица до сих пор называют социологический опрос социальным было каким-то образом задействовано в проекте	ы
Обычно кликуши близки к состоянию эпилепсии и само кликушество является предвозвестником этого тяжёлого заболевания	ы
Задача же катехизации привить церковность а уже скорректировать ее должна будет сама церковная жизнь и проповедь	ии
Я не знаю тех ребят которых прислали сюда в виде армии их мамы наверное тоже сегодня стоят в храме и молятся чтобы их не убили	ы
Сергей Безгласный	ы
Разъезжавшие по ней партии воинства царского сожигали и грабили все селения без изъятия и по праву войны почти неслыханному	ъ
Мы собрались на этой конференции послушать друг друга	ы
_На вопросы отвечает священник Константин Пархоменко сотрудник Отдела по социальному служению Санкт-Петербургской епархии_	ы
Кстати ни на сайте Киевсовета ни градсовета нет данных когда и кому передавались эти участки и когда согласовывались проекты	ы
В 20-х годах прошлого века икону хотели сжечь	чь
По мнению А ЯРОСЛАВСКОГО С ХАРЧЕНКО присуще доскональное знание украинского рынка коммерческих прав опыт привлечения партнеров и спонсоров различных турниров серьезный вклад в развитее детского спорта	аи
Ми надаємо величезне значення цьому як найважливішому етапу в консолідації всіх соціалістичних сил зацікавлених у стабільності країни й у тому щоб міняти владу покращувати владу прокоментував підписання угоди з Левым фронтом Вадим Кумін	ы
Это действительно удивительный человек князь Владимирский Новгородский великий князь Киевский прекрасный дипломат и воин мужественный и даже физически красивый человек	Э
Если священнослужители пытаются всячески спасти семью от развала может быть у них есть готовые формулы предотвращения развода	ы
Может ты Патрушеву отдашь	ы
В своей священной так называемой Велесовой книге они очень негативно высказываются об Аскольде	ы
Я еще раз говорю это зарвавшийся аппетит безответственных политиканов который безусловно мы должны умерить	э
Робоча група з питань підготовки до дострокових виборів продовжує роботу незважаючи на заяви голови Верховної Ради V скликання Олександра Мороза який закликаэ припинити переговори з Президентом	э
Под руками у него даже и в машине на которой мы передвигались по округу всегда был его любимый тогда Адво­кат ликер яично-желтого цвета	ы
Недавно вы в своем блоге написали о симонии в УПЦ о том что протоиерей Виктор Бедь из Закарпатья накопил себе денег на покупку епископства	ы
Господь открыл величие и славу Христа Божественную природу Спасителя	ы
Россия и Украина Россия и Украина Чрезвычайно трудно понять глубокий политический смысл заявлений что украинцы не народ Украина не государство и что надо его расчленить или поглотить	аи
неважно сколько сфабрикованных видеофайлов взятых с YouTube или фальшивых интервью Вы представите в государственных СМИ в качестве новостей о MH 17	ы
_**Борис Моисеевич **_В тюрьму с таким бюджетом надо отправлять	ои
Владимир Филенко вице-президент банка Базис Харьков экс-народный депутат 51 год	э
Выбирайтесь своей колеей	ы
_За матеріалами Спорт-Экспресс	Э
_**Наталія Попова фахівець Укрметртестстандарту Вся эта продукция сегодня на рынках Киева присутствует	э
В Священном Писании она занимает ключевое место	ии
Анализируйте сухие цифры и все	ы
Например договорятся Ющенко с Януковичем что в случае победы Виктор Андреевич предложит Виктора Федоровича на пост премьера разумеется при условии поддержки донецкими кандидатуры Ющенко на выборах	ы
Но древние традиции бережно сохраняемые в обители не были нарушены даже в самые страшные для русского монашества времена	ии
Только бы Господь вразумил окружающих верующих и неверующих людей чтобы мы пришли к познанию истины и спасению своей собственной души	ы
271 Мінчёнок Олександр Олександрович 23.12.1982	ё
Захід продовжує тиснути на режим Олександра Лукашенка в Білорусі повідомляє 22 грудня _Коммерсантъ-Украина_	ъ
Реалии	ии
У листі копія якого є у розпорядженні _Экономических известий_ сказано що в квітні 2004 року 17 співробітникам СБУ були виділені квартири в столичному будинку за адресою вул. Бориспільська 4 будівельна адреса Санаторна 4	Э
Всё что было не со мной помню	ё
При этом мы изначально приняли предложенный Киевом маршрут однако впоследствии украинские власти сообщили что не гарантируют его безопасность и согласились на маршрут Изварино-Луганск заявлють у російському МЗС	э
Контактный телефон храма 098 333 27 51	ы
Соединить противоположные углы квадрата и плотно защипнуть обе стороны	ы
Про це повідомляє Крым	ы
_Когда поймёшь где Гоголь а где Некрасов вот тогда и поговорим	ё
И нравится нам это или нет основан этот код на религии	э
Натомість дружественная страна Росія яка розповідає про общие духовные корни для 4,3 мільйона українців що проживають на її території заклала в бюджет на цей рік ноль российских копеек	ы
Цит за Н Зоркая Советские фильмы на зарубежном экране	ы
Люди молятся кто за сыновей кто за мужей	ы
Желаю всем здоровья и удачи	вь
То что наличие бань прямо связано с культурой а не с лесами показывает и такой факт после ополячивания богатых лесами Галиции и Волыни бани исчезли и там _После великого переселения Руси на Северо-Восток в XI–XII веках вместе с русской культурой русским языком сказками песнями столицей правящей династией из Малой Руси ушло многое	ы
Особливо цей тиск може посилитися у випадку якщо Польща все ж таки введе візовый режим з 2003 р. пише НГ	ы
Когда же Украина стала независимой а я послом продолжает вспоминать Дмитрий Иванович господин Абоимов просто отключил мне телефонную связь	аи
Крім того Партія регіонів претендує на міністерські посади в економічному блоці сказав Т Чорновіл в інтерв'ю газеті Новый понедельник	ы
Завалю печеньем кексом Хочешь торт трюфели на	ье
Губернатор Харьковской области Михаил Добкин выразил желание стать главным ктитором нового храма который планируют возвести к зиме этого года на частные пожертвования	аи
Свой поступок считаю арт-перформансом и посвящаю его Дню Независимости Украины а также всем ребятам которые защищают сейчас мою Родину	сч
Тоді вона сказала що ніколи б не хотіла мати сідниці як у Кардашьян бо вони нагадують їй сміттєвий мішок набитий сиром	шь
Осичев Виктор Анатольевич 1951 г р. Мариуполь ул	ье
Объединение компаний тот инструмент который будет реализовывать эти проекты	ъ
Почти незаметным	ы
Дело в том что социальные сети создаваемые религиозными сообществами могут быть более эффективны чем например сообщества организованные по национальному принципу	ы
Про Тігіпка Ющенка і сильий кулак	ьи
Привык современный человек к бутербродам что поделать	ы
И на приеме к Гончарову ходила в этом золоте там килограммы золота	э
Согласитесь что если Вам с детства постоянно показывать ужасы нацистских концлагерей то Вы определенно станете антифашистом	ы
Чтобы родной храм отбирали силой а тебя называли сепаратистом	ы
Я маю право як виборець так говорити заявив головний санітарний лікар в ефірі радіостанції _Эхо Москвы_	Э
Решение было внесено на рассмотрение депутатом Киевсовета заместителем головы КГГА Виталием Журавским	ы
