в 10.00 возле здания верховний Суда Украины начнется акция обманутых вкладчиков банка Славянский из число членов Социал-демократической партии Украины объединённой	аи
Это опасно	Э
у Шарм-эль-Шейху отруїтися 80 росіянин	э
Например самый младший отец Александр обычно с технар общается отец Павел прекрасно с детьми и подростками работает	ы
про це він заявити в інтерв'ю газета Новые известия	ы
в частности местоблюститель Киевского престола нашей церква митрополит Онуфрий Березовский сказал что произошли страшные события	ои
с какими мыслями печешь кулич такий они будут у той кто этот кулич піт съест	ы
крім той заборонити в'їзд в Україна низка журналіст і громадський діяч а саме керівник агентство Россия сегодня Дмитро Кисельов кореспондент південно-африканського бюро агентство ТАСС Олександр Нечаєв представник агентство РИА-Новости в Туреччина Елену Палажченку президент медіахолдинг Красная Звезда Олександр Піманову редактор газета Известия Олександр Потапов головний редактор журнал Эксперт Валерій Фадєєв головний редактор Российской газеты Владислав Фроніну журналіст телерадіокомпанія ВВС Антон Чичерову головний редактор видання Взгляд ру Олексій Шаравському	Э
Осип Мандельштам вспоминал что для Таинства Венчания он для себя и своей невесты Надежды приобрел именно простенькие и дешевые финифтяные кольца от святой Варвары	аи
а где это видео 4 месяца лежати	э
радуватися якоже сам Христос ближнему послуживый	ы
Почему регистрируются препараты которые лекарствами не являтися	ы
Такое объяснение шити белыми нитка и характер проекта обстоятельства публикации и время его появления говорят о том что истинные причины публикации проекта Постановления Собора совсем иные	ъ
а вот осмысление происшедшего должно продолжаться ввесь жизнь	ы
Церковные люди не должны стояти с протянутой рукой мы должны и себя обеспечивать и ближним помогать	ы
Программа разработанная рабочей группой из представителей Министерства Церквей и научных работников теперь направлений в Министерство образования и наука с рекомендацией предоставить ей соответствующий гриф для последующего использования в учебном процессе	ы
про це заявити мер Одеса Олексій КОСТУСЄВ в інтерв ю радіостанція Эхо Москвы повідомляти Rus NEWSru ua	Э
Как налажена эта работа у ХТЗ	э
_**Harry Potter **_Местная громада сам решает кома должны стояти памятники	ы
убрати зубы	ы
один из самых приближенных к президент Кучме люди	ы
Медведєв і Янукович лише підтвердити що обговорення нове контракт продовжуватися зазначати Новые Известия	ы
Православие в Украине	аи
вулиця розбитий ліхтарів-14 Улицы разбитых фонарей 14 21-36 сер реж.	ы
И тут он услышал голос Ангела о Ибраһим	ы
ми звернутися із заява у **місію всесвітній асоціація газета WAN-IFRA у відповідь на постанова вінницький районний суд про арешт рахунок видавець який видавати газета 20 хвилина і RIA у Вінниця Житомир Хмельницький Тернопіль Козятин і про заборона друкувати в цей газета будь-який інформація про вінницький бізнесмен Эльдара Назарова	Э
митець постійно живий у Трускавець Львівької область де у 1992 рок бути відкрито музей митець	вь
у місто на Нева так багато музикант що фраза гурт Ленінград заводы стоят в стране одни гитарасты лунати як вирок	ы
Именно там в канун своего 65-летия и побывал знаменитый артист вместе с супругой Людмилой Поргиной	ы
Например гендерный абсурд мальчик или девочка сам должны выбрать кем они желают себя ощущать мальчиком или девочкой	ы
я рожденный среди ви	ы
Як передавати місцевий видання Объектив про це повідомити керівник південний пост Віктор Трубчанов	ъ
та ось зіграти у комедія молодий режисер Костянтин Одегова Парижская любовь кість Туманова	вь
Из храма могут только вынести и то лишь по факт публичного обморока	ы
за повідомлення газета Коммерсантъ власник цей фірма вже допитати компанія тимчасово позбавити будівельний ліцензія	ъ
цей матеріал опублікувати на _Корреспондент net__ у рамка партнерський угода з газета __Коммерсантъ-Украина__	ъ
Ігор Лісодід один з активіст який облити минуле тиждень пам'ятник Ленін в Київ червоний фарба заявити що націоналіст мати намір скалічити всі столичний скульптура лідер радянський епоха причетний до голодомор повідомляти Комсомольская правда в Украине	аи
_Удивительным образ все это удаватися сочетать в своей жизни святитель Луке Крымскому	ы
Неоднозначное заявление Надежды Савченко в эфире радио Эра http bykvu com home bukvy 33627 html Ганапольский Назовите три важных шага на ваш взляд которые надо сделать чтобы вернути Донбасс	ы
Почему вы считаете что как мэр бути лучше Добкина	ы
Они не знают что можно а чего категорически нельзя проделывать с муж или женой	ы
не думати о секунда свысока	ы
у будь-який раз скарга не мати жодний підстава тому що фільм містити лише кадри який належати Открытой Россие і кадри новина який не захистити авторський право зазначати Открытая Россия	ы
Также не стоит надевать одежду желтого и красний цвета они стати символическими для сторон конфликта участвовать в акциях или обсуждать происходящее с местным населением	кж
Первое иск по делу о так называемых соцопросах Елисейского дворца	ы
Последний _громкий конфликт в Китаевской пустыни 8 август текущего года_ по мнению настоятель Свято-Троицкого монастыря произошел по причине той что городская власть до сей пор не предоставила жилье люди которые проживают на территории монастыря	ы
Чтобы подниматься было легче можно взяти с собой легкие складные трекинговые палки	ы
тоді бути знищений п'ять бойовик у тому число депутат Унцукульского район республіка від Единой России Магомедхабіб Магомедалієв і лідер Гімрінського угруповання Ібрагім Гаджидадаєв	ии
Наступает Божественная литургия Великой Субботы которая непосредственно соприкасается с праздником Христовий Воскресения	ы
_**Юа Карамба последний украинский гумконвой на 100% состоял из ничего	аи
у МЗС Японія зазначити що під вони потрапити російський банк Сбербанк ВТБ Внешэкономбанк Газпромбанк і Россельхозбанк	э
дехто з безродных космополитов це врятувати дехто все один піти етап	ы
поступати м'яти угрозы физической расправы и в вид писем по почет	ы
у наступний запис від 24 червень 1943 рік він ще раз наголошувати на збройний боротьба УПА з німець за эти дни нервы настолько напряжены что я вторые сутки почти ничего не кушаю	э
і який же бути подив київський інженер-винахідник коли на один зі сторінка він раптом натрапити на такий рядок Черновые запис расчетов хранящиеся в Ленинградском историческом архиве в фонд Балтийского завода дают право считать инициатором этого варианта проекта сам К ратник который возглавлял группу конструкторов работавших над проект т е. прибегая к современной терминологии вероятно сам К ратник и был главным конструктор крейсер	ы
по молитва всего народа и верных учеников святитель Корнилия и Фивы море отступило и люди наслати на дне нерукотворную часовню Ангельскую церковь а в ней тело своего пастыря	ы
И это все натолкнуло меня на мысль почему Всевышний их создал	э
Святыни были торжественно встречены настоятель собора и многими прихожанин Ахтырки и близлежащих сел	ы
И Она Радость всех скорбящих наш Небесная мати простирая Свой державный покров заступит и спасет и помилует всех ми	ы
Реалии	ии
_Эхо Москвы_	Э
Идет эстафета молодогвардейская	э
он не бывает за стіл один у него всегда гости	ы
за матеріал Новая газета Россия Lenta ru Радиостанция Эхо Москвы	Э
Правительство Тимошенко уйдёт в отставку а новое правительство кризис остановит	ё
в которой написати во–первых что я собираюсь работать а во–вторых что они м'яти позвонили а это грязная ложь что я говорил с вони а это опять ложь	ы
Когда Сергей Михалков и Гарольд Эль-Регистан внести изменения в окончательный текст гимна Советского Союза кто-то из писателей назвал их гимнюками	Э
Херсон в небольшом селе Касперово которое ныне называется Кизомыс Белозерского района Херсонской области в семье незнатной и по мирскому положению далеко не превознесенной благоугодно было Матери Божией просиять знамениями и чудо	ы
найкращий свідчення це бути по-справжньому високий попит на модель **Sens Lanos пікап і VIDA** саме з газбалонным обладнання	ы
ввесь мировая история иллюстрация к этим слово	э
Юродствовал прославился как провидец предрек основание киевских Троицкого Ионинского и Покровского монастырей Преображенского скита Китаевской пустыни	ои
тема кто только планирует свій первую поездку или мечтает о подарке со Святой Горы мы расскажем о том что можно привезти с Афон	ы
середа факелоносець заключний етап бути дворазовий олімпійський чемпіонка зі стрибок з жердина Олена Ісінбаєва а також президент міжнародний федерація хокей на лід IIHF Рене Фазель модель Наталя Водянова министр оборона РФ Сергый Шойгу повідомляти РИА Новости	ы
Мы сделаем так как положено	ы
**Дмитро Боярчук генеральный директор CASE Ukraine**	ы
Получил продолжение острый конфликт между житель урочище Китаево что в Голосеевском район Киева и монах Свято-Троицкого мужского монастыря УПЦ МП	ы
